0 0 0 0 0 0 0 0 0 0 0 0 0 0 0 0 0 0 0 0 0 0 0 0 0 0 0 0
0 0 G G G G G 0 0 0 0 0 G G G 0 0 0 0 0 0 0 0 0 0 0 0 0
0 0 G G G G G G G G 0 0 G I G 0 0 0 G G G G 0 0 0 0 0 0
0 0 G G G G G 0 0 G 0 0 G G G 0 0 0 0 0 0 G 0 0 0 0 0 0
0 0 0 0 G 0 0 0 0 G 0 0 0 G 0 0 0 0 0 0 0 G 0 G G G G 0
0 0 0 0 G 0 0 0 0 G G G G G G G G G G 0 0 G G G G G G 0
0 0 0 0 G 0 0 0 0 0 0 0 0 G 0 0 0 0 G 0 0 0 0 G G G G 0
0 0 G G G G G 0 0 0 0 0 0 0 0 0 0 0 G 0 0 0 0 G G G G 0
0 0 G G G G G G G G G G G G G G G G G 0 0 0 0 0 0 G 0 0
0 0 G G G G G 0 0 0 0 0 0 0 0 0 0 0 0 0 0 0 0 0 0 G 0 0
0 0 0 0 G 0 0 0 0 0 0 0 0 0 G G G G G G G G 0 0 0 G 0 0
0 0 0 0 G 0 0 0 0 0 0 0 0 0 G G G G G G G G 0 0 0 G 0 0
0 0 0 0 G 0 0 G G G G G 0 0 G G G G G G G G 0 0 0 G 0 0
0 0 G G G G G G G G G G G G G 0 0 0 G 0 0 0 0 0 0 G 0 0
0 0 0 0 0 0 0 G G G G G 0 0 0 0 0 0 G 0 0 0 0 0 0 G 0 0
0 0 0 0 G 0 0 0 0 G 0 0 0 0 0 0 G G G G G 0 0 0 0 G 0 0
0 0 0 0 G 0 0 0 0 G 0 0 0 0 0 0 G G G G G G G G G G 0 0
0 0 0 0 G 0 0 0 0 G G G G G 0 0 G G G G G 0 0 0 0 G 0 0
0 0 G G G G 0 0 0 G 0 0 0 G 0 0 0 0 G 0 0 0 0 0 0 G 0 0
0 0 G 0 0 G 0 0 0 G 0 0 0 G 0 0 0 0 G 0 0 0 0 0 0 G 0 0
0 0 G 0 0 G 0 0 G G G G G G G G G G G G G G G G G G 0 0
0 0 G 0 0 0 0 0 0 0 0 0 0 0 0 0 0 0 G 0 0 0 0 G 0 0 0 0
0 0 G G G G G G 0 0 G G G G G G G G G G G G 0 G 0 0 0 0
0 0 G 0 0 G G G 0 0 G 0 0 G 0 0 0 0 G 0 0 0 0 G 0 0 0 0
0 0 G 0 0 G G G 0 0 G 0 0 G 0 0 0 0 G 0 0 G G G G G 0 0
0 0 G 0 0 G G G G G G 0 G $ G 0 0 0 G G G G G G G G 0 0
0 0 0 0 0 0 0 0 0 0 0 0 G G G 0 0 0 0 0 0 0 0 0 0 0 0 0
0 0 0 0 0 0 0 0 0 0 0 0 0 0 0 0 0 0 0 0 0 0 0 0 0 0 0 0
