0 0 0 0 0 0 0 0 0 0 0 0 0 0 0 0 0 0 0 0 0 0 0 0 0 0 0 0
0 G G G 0 0 0 0 0 0 0 0 0 0 0 0 0 0 0 0 0 G G G 0 0 0 0
0 G G G 0 0 0 0 0 0 0 0 G G G 0 0 0 0 0 0 G G G 0 0 0 0
0 0 G 0 0 0 0 G G G G G G C G 0 0 0 0 0 0 G G G 0 0 0 0
0 0 G 0 0 0 0 G 0 0 0 0 G G G 0 0 0 0 0 0 0 G 0 0 0 0 0
0 0 G G G G G G 0 0 0 0 0 0 0 0 0 0 0 0 0 0 G 0 0 0 0 0
0 0 G 0 0 0 0 0 0 0 0 0 0 0 0 0 0 0 0 0 0 0 G 0 0 0 0 0
0 0 G 0 0 0 0 0 0 0 0 0 0 0 0 0 0 0 0 G G G G G G G 0 0
0 0 G 0 0 0 0 0 0 0 0 0 0 0 0 0 0 0 0 G G G G G G G 0 0
0 0 G G G G G G 0 0 0 G G G G G 0 0 0 G G G G G G G 0 0
0 0 0 G 0 0 0 G 0 0 0 G G G G G 0 0 0 G G G G G G G 0 0
0 0 0 G 0 0 0 G 0 0 0 0 0 G 0 0 0 0 0 0 0 0 G 0 0 0 0 0
0 0 G G G 0 0 G 0 0 0 0 0 G 0 0 0 0 0 0 0 0 G 0 0 0 0 0
0 0 G G G 0 0 G 0 0 0 0 0 G 0 0 0 0 0 0 G G G G G 0 0 0
0 0 G G G 0 0 G 0 0 0 0 0 G 0 0 0 0 0 0 G 0 0 0 G 0 0 0
0 0 0 0 0 0 0 G G G G G G G G G G G G G G 0 0 0 G 0 0 0
0 0 0 0 0 0 0 G 0 0 0 0 0 0 0 0 0 0 0 0 G 0 0 0 G 0 0 0
0 0 0 0 0 0 0 G 0 0 0 0 0 0 0 0 0 0 0 0 G 0 0 0 G 0 0 0
0 0 G G G 0 0 G 0 0 G G G 0 0 0 0 0 G G G G 0 0 G 0 0 0
0 0 G G G G G G G G G G G 0 0 0 0 0 G G G G 0 0 G 0 0 0
0 0 G G G 0 0 G 0 0 G G G 0 0 0 0 0 G G G G 0 0 G 0 0 0
0 0 0 0 0 0 0 G 0 0 0 0 0 0 0 0 0 0 0 0 0 0 0 0 G 0 0 0
0 0 0 0 0 0 0 G 0 0 0 0 0 0 G G G G G G G G G G G 0 0 0
0 0 0 0 0 0 G G G G 0 0 0 0 G 0 0 0 0 0 0 0 0 0 0 0 0 0
0 0 0 0 0 0 G G G G 0 0 0 0 G 0 0 0 0 0 0 0 0 0 0 0 0 0
0 0 0 0 0 0 G G G G 0 0 G G G G G 0 0 0 0 0 0 0 0 0 0 0
0 0 0 0 0 0 0 0 0 0 0 0 G G # G G 0 0 0 0 0 0 0 0 0 0 0
0 0 0 0 0 0 0 0 0 0 0 0 0 0 0 0 0 0 0 0 0 0 0 0 0 0 0 0
