F F F F F F F F F F F F F F F M M M M M M M M M M M M M M M M M M M M M M M M M M M
F G + F G F G F G G G G G G G M M M M M M M S S % S S M M M M M M S S S S M M M M M 
F G G F G G G F G F G G G G G G M M M M M S S S S S S S M M M M S S S S S S M M M M 
F G F F G F G F G F G G F G G G G M S S S S S S S S S S S S S S S S S S S S S S M M 
F G G G G F G F G F G G F G G G G M S M M S S S S S S S M M M M S S S S S S M M M M 
F G F F G F G F G F G F F F G G G M S M M M S S S S S M M M M W M S S S S M W M M M 
F G F F G F G G G F G G G G G G G M S M M M M M M M M M M M M W M M M M M M W M M M
F G F F F F G F F F G G G G G G G M S M M M M M M M M M M M M W M M M M M M W M G M 
F G G F G G G G G F G G W G G G G M S S S S S S S S S S S M M W M M M M M M W M G M 
F F F F G F F F G G G W W W G G G M S M M M M M S M M M S M M W M M M M M M W M G M 
F G G F G G G G G G W W W W W G G M M M F F F M M M F F F F F W G G M M G G W G G M 
F G G F G G F G G G G W W W G G G G G G G G G G G G G G G G W W W W W W W W W G G M 
F G G F G G F G G G G G W G G G G G G G G G G G G G G G G G W G G F G G G G G F G M 
F G G F G G F G G G G G G G G G G F F F G G G F F F F G G G W G G G G G G F G F G M 
F G G G G G G G G G G G G G G G G G G G G G G G G G G G G G W G F G F G F F G F G M 
F G F F F F F G F F F G G G G G G G G G G G G G G G G G G G W G G G G G G G G G G M 
F G G G G G G G G G G G G G G G G W W W W W W W W W W G G G G G M M M M M M M M M M 
F G G G G G G G G W G G F G F G G W G G G G G G G G W G G G W G M S S S S S S $ S M 
F G F G G F G G G W G G G G G G G W G F G G G G F G W W W W W G M S M S S M S S S M 
F G F G G F G G G W G G F G F G G G G G G G G G G G W G G G G G M S M M M M M M M M 
F G F G G F G G G W G G G G G G G W G G G G G G G G W G G G M G M S S S S S S S S M 
F G F G G F G G G W G F F F F G G W G F G G G G F G G G G G M G M S M M M M S M M M 
F G G G G G G G G W G G G G G G G W G G G G G G G G W G M G M G M S S S S S S S S M 
F G G G G G G G G G G F F F F G G W W W W G G W W W W G M G M G M M M S S M M M M M 
F F F F F F F G G F F F F F F F F F G G G G G G G G W G M G M G G G G G G G G G G M 
F F F F F F G G F F F F F G F F F F F G F F F G G G W G M G G G G G G G G G G G G M 
F G F G F G G G F F F F G G G F F F F G F F F G G G W G M G G G M M M M M M M M M M 
M G G G F G G G F F F G G G G G F F F G G G G G G G W G G G G G G G G M G G G G G M 
M G G G F G G G F F F F G G G F F F F G F G G G G G W G G G G G G G G M G G G G G M 
M G G G G G G G G F F F F G F F F F G G F G G G G G W W W G W W W W G M G M M M M M 
M G G G G G G G G G G G G G G G G G G G G G G G G G G G G G G G G W G G G G G G G M 
M M M M M M M M M G G G G M M M M M M M G G M M M M G G G G G G G W M M M M M M G M 
M S S S S # S S M G G G G M G G G G G G G G G G G M G G G G G G G W M M M M M M M M 
M S M M S S S S M G G G G M G G G G G G G G F G G M G G W W W W W W W W M M W W M M 
M S M M S S S S M G G G G M G F G G W W G G F G G M G G W W M W W W W W M M W W M M 
M S S S S S S S M G G M G M G G G G W W G G F G G M G G W W W W M M W W M M W W M M 
M S S S S S S S M G G M G G G G G G G G G G G G G M G G W W W W M M W W M M W W M M 
M S S S S S S M M M M M G G F G G G G G F F F G G M G G W W W W W W W W M M W W M M 
M S S S S S S S S M M M G G F G W W W G G F G G G M G G W W W W W W W W M M W W M M 
M S S S S S S S S M M M G G F G G G G G G F G G G M G G W W W W W W W W W W W W M M 
M S S S S S S S S S G G G G G G G G G G G G G G G M M M W W W W W W W W W W W W M M 
M M M M M M M M M M M M M M M M M M M M M M M M M M M M M M M M M M M M M M M M M M
